名詞-普通名詞	NN
助詞-格助詞	PPM
動詞	VV
名詞-サ変名詞	NNV
助詞-接続助詞	PPC
特殊-読点	,
接尾辞-動詞性接尾辞	SFV
特殊-句点	.
助詞-副助詞	PPR
形容詞	JJ
副詞	RB
名詞-数詞	CD
判定詞	CO
接尾辞-名詞性名詞助数辞	SFQ
接尾辞-名詞性名詞接尾辞	SFNN
名詞-時相名詞	NNT
名詞-形式名詞	NNF
助動詞	MD
名詞-人名	NNP
名詞-副詞的名詞	NNR
特殊-記号	SYM
接尾辞-形容詞性述語接尾辞	SFJP
接頭辞-名詞接頭辞	PFN
名詞-地名	NNL
特殊-括弧終	)
特殊-括弧始	(
指示詞-連体詞形態指示詞	DDM
指示詞-名詞形態指示詞	DDN
接続詞	CC
名詞-固有名詞	NNA
名詞-組織名	NNO
接尾辞-形容詞性名詞接尾辞	SFAN
連体詞	NM
助詞-終助詞	PPF
接尾辞-名詞性特殊接尾辞	SFNS
接尾辞-名詞性述語接尾辞	SFNP
感動詞	UH
特殊-空白	SP
接頭辞-ナ形容詞接頭辞	PFA
接頭辞-イ形容詞接頭辞	PFI
指示詞-副詞形態指示詞	DDR
接頭辞-動詞接頭辞	PFV
未定義語-その他	UNK
